01111001100111100100
00101111101000001001
10101000010010001100
00110001110000000110
00101000101110101000
10110101101001100010
01010000100100000100
11110100110101101011
11100010000101111110
11011101111011011110
00110110011011001101
01011010011011101100
10101000101001000101
11101010111100011101
11100011111111001001
00110001011111011110
00100010100100101011
10001111110010010001
10001010110011001101
01111001000001101110
